8 8
174 174 174 174 174 174 174 174
174 4 67 77 132 132 132 174
174 64 67 78 132 132 132 174
174 114 174 174 174 174 132 174
174 132 132 132 132 174 132 174
174 132 25 67 86 174 135 174
174 132 132 132 132 132 132 174
174 174 174 174 174 174 174 174
