9 9
174 174 174 174 174 174 174 174 174
174 4 67 77 132 132 132 132 174
174 51 67 79 132 132 132 132 174
174 65 67 88 132 132 132 132 174
174 114 161 175 132 132 132 135 174
174 132 132 132 132 132 132 132 174
174 132 25 67 86 132 132 132 174
174 132 132 132 132 132 132 132 174
174 174 174 174 174 174 174 174 174
