9 8
174 174 174 174 174 174 174 174 174
174 4 67 77 132 132 132 132 174
174 132 132 132 132 132 132 132 174
174 114 132 132 132 132 132 135 174
174 132 132 132 132 132 132 132 174
174 25 132 67 132 86 132 132 174
174 132 132 132 132 132 132 132 174
174 174 174 174 174 174 174 174 174
