9 8
174 174 174 174 174 174 174 174 174
174 4 67 77 51 67 77 132 174
174 51 67 79 132 132 132 132 174
174 132 132 132 132 132 132 132 174
174 114 132 174 174 174 132 135 174
174 132 161 132 132 132 132 132 174
174 132 132 132 132 25 67 86 174
174 174 174 174 174 174 174 174 174
