9 8
174 174 174 174 174 174 174 174 174
174 4 67 77 132 132 132 132 174
174 132 132 132 132 132 132 132 174
174 114 132 174 132 132 132 135 174
174 132 132 174 132 132 132 132 174
174 132 132 174 132 132 161 132 174
174 51 67 77 25 67 86 132 174
174 174 174 174 174 174 174 174 174
