9 8
174 174 174 174 174 174 174 174 174
174 4 67 77 132 132 132 132 174
174 39 67 92 132 132 132 132 174
174 20 67 91 132 132 132 132 174
174 114 132 130 132 130 132 135 174
174 132 132 132 132 132 132 132 174
174 132 149 132 149 25 67 86 174
174 174 174 174 174 174 174 174 174
