10 6
174 174 174 174 174 174 174 174 174 174
174 4 67 77 132 132 132 132 132 174
174 114 132 132 132 25 67 86 132 174
174 132 132 132 132 132 135 132 132 174
174 132 132 132 132 132 132 132 132 174
174 174 174 174 174 174 174 174 174 174
